100000002
010000003
001000004
000100004
000010003
000001000
000000100
000000010
000000001
000000010
000000100