44444444444
40000000004
40000900004
40000000004
40000000004
40000000004
40000000004
40000000004
40020020004
40004400004
40001100004
44444444444